NO ./textures/set2/north.xpm
SO ./textures/set2/south.xpm
WE ./textures/set2/west.xpm
EA ./textures/set2/east.xpm

F 80,80,80
C 130,130,130

1111111111111111111111111
1000000000110000000000001
1011000001110000000000001
1001000000000000000000001
1111111110110000011100001
10000000001100000111011111111111
11110111111111011100000010001
11110111111111011101010010001
11000000110101011100000010001
10000000000000001100000000001111111111111111111111111111111111111111111111111111111111111111111111111111111111111111111111
10000000000000001101010000000000000000000000000000000000000000000000000000000000000000000000000000000000000000000000000001
11000001110101011111011110N01111111111111111111111111111111111111111111111111111111111111111111111111111111111111111111111
11110111 1110101 101111010001
11111111 1111111 111111111111