NO ./textures/set3/north.xpm
SO ./textures/set3/south.xpm
WE ./textures/set3/west.xpm
EA ./textures/set3/east.xpm

F 80,80,80
C 130,130,130

1111111111111111111111111
1000000000110000000000001
10110000011100000000000011111111111111111111111111111111111111111111111111111111111111111111111111111111111111111111
10010000000000000000000000000000000000000000000000000000000000000000000000000000000000000000000000000000000000000001
11111111101100000111000011111111111111111111111111111111110111111111111111111111111111011111111111111111111111111101
10000000001100000111011111111111                         101                         101                         101
11110111111111011100000010001                            101                         101                         101
11110111111111011101010010001                            101                         101                         101
11000000110101011100000010001                            101                         101                         101
10000000000000001100000000001111111111111111111111111111110111111111111111111111111111011111111111111111111111111101
10000000000000001101010000000000000000000000000000000000000000000000000000000000000000000000000000000000000000000001
11000001110101011111011110N01111111111111111111111111111111111111111111111111111111111111111111111111111111111111111
11110111 1110101 101111111101
11111111 1111111 111111111111