NO ./textures/set4/north.xpm
NO2 ./textures/set4/north_a.xpm
NO3 ./textures/set4/north_b.xpm
NO4 ./textures/set4/north_c.xpm
SO ./textures/set4/south.xpm
WE ./textures/set4/west.xpm
EA ./textures/set4/east.xpm
D ./textures/set4/door.xpm

F 80,80,80
C 130,130,130

      111111
1111111111111111111111111
1000000000110000000000001
1D11000001110000000000001111111111
1001000000000000000000000000000001
1111111110110000011100001111111111
10000000001100000111011111111111 
11110111111111011100000010001
11110111111111011101010010001
11000000110101011100000010001
10000000000000001100000000D1111
1000000000000000110101000000001
 1000001110101011111011110N00111
 1110111 1110101 1011111111011111
 1111111 1111111 111111111111