NO ./textures/set_bonus/north.xpm
NO2 ./textures/set_bonus/north_a.xpm
NO3 ./textures/set_bonus/north_b.xpm
NO4 ./textures/set_bonus/north_c.xpm
SO ./textures/set_bonus/south.xpm
WE ./textures/set_bonus/west.xpm
EA ./textures/set_bonus/east.xpm
D ./textures/set_bonus/door.xpm

F 80,80,80
C 130,130,130

      111111
1111111111111111111111111
1000000000110000000000001
1D11000001110000000000001111111111
1001000000000000000000000000000001
1111111110110000011100001110111111
10000000001100000111011111101111 
111101111111110111000D0010001
1111D111111111D111D1110011D11
110000001101010111000D0010001
100000000000000011000100D001111
100000000000000011010D001000001
 1000001110101011111011110N00111
 1110111 1110101 1011111111011111
 1111111 1111111 111111111111